1111111
100P1C1
1E10001
1111111
