1111111
100E001
1000001
100P001
1000001
100C001
1111111
