1111111
1P00001
1111101
100X0C1
1011111
1C0C0E1
1111111
